................................................................................
................................................................................
................................................................................
....................c...........................................................
.g..lm.a..12..h.d...1.k.d.d...lcccc...k.j...cccm....2...i..i........2...........
111111111111f111111111111111111111111111111111111111111f11111111111111f111111111
