..............................................................................
..............................l....l..........................................
..............................................................................
....................c..........................m..............................
.g..lm.a..1.f.h.d...1.k.d.d...lccccf..k.j...cccm........i..i.................2
111111111111.1111111111111111111111.111111111111111111111111111111111111111111
111111111111111111111111111111111111111111111111111111111111111111111111111111
