...................1111.......................1...............................
...............cd......................111...11...c.....c.....................
............11111............................11..11111111...........1.........
.............................................................11....11.........
.g....a.............1...d1...c.1......c..d........................111c.c..c1.2
111111111111111111111111111111111111111111111111111111111111111111111111111111
