...................1111................dd....l1...............................................
...............cd......................111...11...c.....c.....................................
.............................................11.....................1.........................
.........................i...................................11....11.........................
.a...g........mlh....1...d1...c.1.j....c..d..k..h.....d.....k..h..111c.c..c1.2.h..m.....dd....
11111111111111111111111111111111111111111111111111111111f1111111111111111111111111111f11111111




